...................#
.....###########....
...............#....
...............#....
....................
....................
....................
....................
....................
...#................
...#................
...#................
....................
....................
....................
.....##########.....
....................
....................
....................
#..................#